0000000000000
0000000000000
1000000000000
0001111111000
0001111111000
0001111111000
0001111111000
1001111111000
0001111111000
0001111111000
0000000000000
0000000000000
0000000000000
