0000000000000
0000011000000
0001111100000
0011111111100
0111111111110
0111100011110
0111000001110
1111100011110
0111111111110
0011111111100
0001111110000
0000011100000
0000000000000
